0,0,0,0,0,0,0,0,0,0,0,0,0,0,0,0
0,0,0,0,0,0,0,0,0,0,0,0,0,0,0,0
0,0,0,0,0,0,0,0,0,0,0,0,0,0,0,0
0,0,0,0,0,0,0,0,0,0,0,0,0,0,0,0
0,0,0,0,0,0,0,0,0,0,0,0,0,0,0,0
0,0,0,0,0,0,6,0,0,0,7,0,0,0,0,0
0,5,0,0,0,0,0,0,0,0,0,0,0,0,0,0
2,2,2,1,1,2,2,1,1,2,2,1,1,2,2,2
2,2,2,0,0,0,0,0,0,0,0,0,0,2,2,2